#$##############################################################################
#....#       # ## ##   ## ##   ##  #     # ##     # ### ##          # # #  ##  #
####.####### # ## ## ###   ### ###   ###      # #    #   # # ###### # #   ### ##
####.#  # ## # #       ## ## # # ##### ### #### ## #   ######### #      ###    #
#   .##        ###### ##       # ## #  # ############ ## ## #  #   # ##  ##### #
####. ### #### ## ##   ####### # ## ## # ##   ##       # #  ##   # # #  ##     #
####.###  ##...## ### ## #  ## # ##      ####    ##### # ##  ##########  #### ##
#   ...####..#....#   ## ## #     ######  ### ###### # # ###   ## ##  # ###    #
#### #...#..### #.###       #### ## # #  ## # #        # # ### #   ##   # #### #
#    # #...## ###.# ### ### # #     # ##  # # ######## # #  ## # ###  #   ##   #
## # ##### ##  # ..  #####  # #####    ## # #####        # ##  # # ###### #### #
####### ###### ###.### # ## # ## ### #       ## ###### #    ##   #  #   #  ### #
# # ##      #     ..## # #    ##  ######### ##    ## ###### #### ## ###   ## # #
#    ######   ## ##......### #### # # #   #  #### #   # #        ## # ### ##   #
### ## # #### ##  ### ##.......## # # ###   ## #  ### # # ##### ### #   #    ###
### #         #  ########## ##.#  # # # ###    ## #     ### ##  # # ### ####  ##
# # ###### ## ## #        ####.##...# # ######  # #####  #  ###         ## ##  #
#          #  #### #### #  # #....#.....# ## ##...# # ## ## # ####### # #  ## ##
## # ### # ## # ## #    ##     ## ## ##.........#...........# ##  # ### ## ##  #
############### #  # ####  ### ## ###### #### #############.# ### # ##     ### #
#         ##### ## ### ### #   ## # ## # ##   ##  #    #   .#   # # #### #   # #
# # # # #  ## #  ####    # # # ## #  #    ### ### #### ####.### # # # ###### # #
##########      ##    ## # # # ## ##   # ###  #            .........# # #    # #
#   ## # ######  ######    # # ###### #####  ## ##### # ###########...# ####   #
## ##  # ###### ## # ### ### ### # #  # #   ######    #######       #.....   # #
#   ##   #         # # #  ## ### # #### ######     # ###      # ## ### ##.# ## #
## ##### #########       ##  #     #     ### ####### ##  ###### #  ######.# ## #
#         # # ##### ####  ## ##### #####          ##  ## #      ##  ##   .# #  #
###### ##   # #   ###    ##  #  ## ## ######### #    ######## # ## ######.#### #
#  # ###### # # ########  # ###       # ###   ### #### ## ##### ##### # ..##   #
## # ## # #       #   ####### ####### # # ###     #              ## # ##.#### ##
#    ##     # ### ###     ##          # # #### ## # ###### ## # ##      .##    #
# ## ##########    ######    # #### #        #  ###### ########  ## # ##..## ###
###   ## ### #####        # ####    #### ###   ##  #            ##  #####. #   #
#### ##  # #  ###  # # ## # ##   # ##      ###  ## ##### ## # #  ## #    .######
# #  ###   ## #   ####### # ## ###  #### ########        ## # # ##  # ###.#    #
#   ## ### ## ##### # ##  #######  ########   #   ##### ### # # ########..  # ##
###              #     ##### #    ###  ## ### #####     #   #####  ### #.####  #
#   # # # # #### ##### # #   ## # # ## #         #  # ######## ###  #....  ## ##
### # ####### #  ## ## # ### ######    ##### ### ########       ###  .# # ######
### # ##      ##         ##   ## ### #  #    #     # #    # # #     #*###     ##
# # #  ## # #    ### ### #### ## # #### # ########     # ## ### # # #, ## ###  #
#   ## ###### ########   # #     # ###  ### #      ## ##  #  #### ###,##    # ##
# #  # # # ####### ##  #     # #     ##  #  #### # #  #  ## ## #  #  ,,## # #  #
# # ####   # #        ## ### ##### # ### ## ##   # ## ## ####    ### #, ##### ##
# #####  #     #### ###    # ##    #           # ######### #  # ##   #,### ##  #
#### #  ## # # #    ### #### ####### ###### ## ##### #       ####  # #,,,   # ##
#  #   ############ #    ##### # ### #       #####     ## # ##    ## # #,## ####
## ###   ##         ## ### ### #     #### ##  ##   ## ##  #  ### ##  # #,##    #
#      # #### # ### #  ##      ## ####    #  ##  # #  ### ##  ###### # #,,## ###
## # # ###    ###   ## ####### ####### ## ##  ## # ##   #### ##      # ##, #   #
#  # #  #### ###### ## # ### # # #     ##### ### #  ## ##     ## # # # ##,######
## ### ##  #### # ###  #       # #######     ##  ########## ######## # ##,,#####
#  #######         #  ### ####    ## ### # # ## ##            # #### #####,,,  #
#### ## ########## ##   ###    ##        ### ##  ## # # ## # ##  # # ##### #,###
###       ##          # #### #  ## # # #  ##  ##  ### ###  #  ##       ##  #,  #
# ## ####    ## # # # # #  # # ##  # # ## ## ##  ##   ##  ## ##  # # ###  ##,###
# #### #### ##### # # ####   # ### # #  ###   ## ####### ##   ######   #### ,,##
#           #     # # #    # #   # # # ##   #  # #        ## ##      #    # #,,#
##############################################################################,#
