## #####################
#       #  #  #    #   #
#####  ##  #  #    # ###
#             #        #
#  #########  #    #   #
#             #    #   #
###### ###       ####  #
#        ######  #     #
#   ####      #        #
#      ###### ###### ###
#   #                  #
###################### #