# ##############################################################################
#    #       # ## ##   ## ##   ##  #     # ##     # ### ##          # # #  ##  #
#### ####### # ## ## ###   ### ###   ###      # #    #   # # ###### # #   ### ##
#### #  # ## # #       ## ## # # ##### ### #### ## #   ######### #      ###    #
#    ##        ###### ##       # ## #  # ############ ## ## #  #   # ##  ##### #
####  ### #### ## ##   ####### # ## ## # ##   ##       # #  ##   # # #  ##     #
#### ###  ##   ## ### ## #  ## # ##      ####    ##### # ##  ##########  #### ##
#      ####  #    #   ## ## #     ######  ### ###### # # ###   ## ##  # ###    #
#### #   #  ### # ###       #### ## # #  ## # #        # # ### #   ##   # #### #
#    # #   ## ### # ### ### # #     # ##  # # ######## # #  ## # ###  #   ##   #
## # ##### ##  #     #####  # #####    ## # #####        # ##  # # ###### #### #
####### ###### ### ### # ## # ## ### #       ## ###### #    ##   #  #   #  ### #
# # ##      #       ## # #    ##  ######### ##    ## ###### #### ## ###   ## # #
#    ######   ## ##      ### #### # # #   #  #### #   # #        ## # ### ##   #
### ## # #### ##  ### ##       ## # # ###   ## #  ### # # ##### ### #   #    ###
### #         #  ########## ## #  # # # ###    ## #     ### ##  # # ### ####  ##
# # ###### ## ## #        #### ##   # # ######  # #####  #  ###         ## ##  #
#          #  #### #### #  # #    #     # ## ##   # # ## ## # ####### # #  ## ##
## # ### # ## # ## #    ##     ## ## ##         #           # ##  # ### ## ##  #
############### #  # ####  ### ## ###### #### ############# # ### # ##     ### #
#         ##### ## ### ### #   ## # ## # ##   ##  #    #    #   # # #### #   # #
# # # # #  ## #  ####    # # # ## #  #    ### ### #### #### ### # # # ###### # #
##########      ##    ## # # # ## ##   # ###  #                     # # #    # #
#   ## # ######  ######    # # ###### #####  ## ##### # ###########   # ####   #
## ##  # ###### ## # ### ### ### # #  # #   ######    #######       #        # #
#   ##   #         # # #  ## ### # #### ######     # ###      # ## ### ## # ## #
## ##### #########       ##  #     #     ### ####### ##  ###### #  ###### # ## #
#         # # ##### ####  ## ##### #####          ##  ## #      ##  ##    # #  #
###### ##   # #   ###    ##  #  ## ## ######### #    ######## # ## ###### #### #
#  # ###### # # ########  # ###       # ###   ### #### ## ##### ##### #   ##   #
## # ## # #       #   ####### ####### # # ###     #              ## # ## #### ##
#    ##     # ### ###     ##          # # #### ## # ###### ## # ##       ##    #
# ## ##########    ######    # #### #        #  ###### ########  ## # ##  ## ###
###   ## ### #####        # ####    #### ###   ##  #            ##  #####  #   #
#### ##  # #  ###  # # ## # ##   # ##      ###  ## ##### ## # #  ## #     ######
# #  ###   ## #   ####### # ## ###  #### ########        ## # # ##  # ### #    #
#   ## ### ## ##### # ##  #######  ########   #   ##### ### # # ########    # ##
###              #     ##### #    ###  ## ### #####     #   #####  ### # ####  #
#   # # # # #### ##### # #   ## # # ## #         #  # ######## ###  #      ## ##
### # ####### #  ## ## # ### ######    ##### ### ########       ###   # # ######
### # ##      ##         ##   ## ### #  #    #     # #    # # #     # ###     ##
# # #  ## # #    ### ### #### ## # #### # ########     # ## ### # # #  ## ###  #
#   ## ###### ########   # #     # ###  ### #      ## ##  #  #### ### ##    # ##
# #  # # # ####### ##  #     # #     ##  #  #### # #  #  ## ## #  #    ## # #  #
# # ####   # #        ## ### ##### # ### ## ##   # ## ## ####    ### #  ##### ##
# #####  #     #### ###    # ##    #           # ######### #  # ##   # ### ##  #
#### #  ## # # #    ### #### ####### ###### ## ##### #       ####  # #      # ##
#  #   ############ #    ##### # ### #       #####     ## # ##    ## # # ## ####
## ###   ##         ## ### ### #     #### ##  ##   ## ##  #  ### ##  # # ##    #
#      # #### # ### #  ##      ## ####    #  ##  # #  ### ##  ###### # #  ## ###
## # # ###    ###   ## ####### ####### ## ##  ## # ##   #### ##      # ##  #   #
#  # #  #### ###### ## # ### # # #     ##### ### #  ## ##     ## # # # ## ######
## ### ##  #### # ###  #       # #######     ##  ########## ######## # ##  #####
#  #######         #  ### ####    ## ### # # ## ##            # #### #####     #
#### ## ########## ##   ###    ##        ### ##  ## # # ## # ##  # # ##### # ###
###       ##          # #### #  ## # # #  ##  ##  ### ###  #  ##       ##  #   #
# ## ####    ## # # # # #  # # ##  # # ## ## ##  ##   ##  ## ##  # # ###  ## ###
# #### #### ##### # # ####   # ### # #  ###   ## ####### ##   ######   ####   ##
#           #     # # #    # #   # # # ##   #  # #        ## ##      #    # #  #
############################################################################## #
