# ,###############################################
# , # # # # # ## # # # #    # ##  ##  ## # ## #  #
# ,     #   # #      # #### #  ##    ##  # #    ##
##,,,,,,,## # ######    ##  # ##  ####  ## ####  #
#     # ,#    # ####### ### #  ##  # ## ##    ## #
## ##   ,  ##                 ##  ## #   ### ##  #
####### ,####### # # ### ####    ### # ####   ## #
# # # # ,,,,,##############   #####     ##  ###  #
# # # ### ##,,.................   ##### ###   ## #
#      #  #  , ##   ### ######.#### #........... #
###### ## #,,,##### ##    #   ... #  .##   ## #. #
# ##   #  #,### # #  #### ### # ......## #### #. #
#  ### # ##,      ##  # # ##### ### # #   ##  #. #
# ##   #  #,*####  ##        #   ##   ## #### #.##
#  ### # ## # # ## ######### ## ##  ###   # # #.##
# ##   # ##     #  # #             ## # ###    . #
#  ### # ###### ## # #### ###### ###  # # #####. #
##       # ## # #     #####        ## #     ## . #
##### ## # #    #### ##   ######## ##   ###  ##.##
# ######     ##  #    # #####   ## ####  ####... #
#        # #####   ## #  ##....##   # # ## # .# ##
####### ##### ######    ##.. #. #.............   #
# ## #####    # ###  ##  #.# #....    # ## ##### #
#    # # #### # # ######...    ### ##    #  ## # #
## #               ##  #.##### # ##### ### ##  # #
###### ## ## ### #  # ##.##  # #  ##   # #  ## # #
# ## ##############      ### # ## #### #   ##  # #
# #        ##   # ######       ## # #  ## ### ## #
# ########    #          # ### #      ### # # ## #
#     #    ##### # # # ####### ###### # # # # #  #
##### ######## ########## #             # # # # ##
#     # # #     # ##  #   ####### ##### # # # # ##
#####   # ##### # ###   #  # ###  ##      # #    #
####### # ## #        ####       ##  #### # # ####
#          # #### ###### ## # ###### #    # #  # #
##### # ##    # ####      # # #    #### #     ## #
## ########## # ###  ####   # ## #    ##### ###  #
#     ## #  # # # ####    # # ####### #     # ## #
### ###  ##   # # ####### ### # # ### ### #    # #
#   # # ##  #        # ########        ##### #   #
# #        ### # ## ##   #  ###### # #     # ## ##
# ## #### ## ### ##  ### ## # ##   #######   ##  #
#  ####   ##      ##           ## ### ###  # ## ##
# ##    #  ## # ###  ## # # ##    ##      ####   #
#  ## # # ##### #   ################### # #    ###
# ##  ###  ##   ### #                 ###### # ###
#  #####  #### ##   # # ########### #        #   #
# #### # ##### #  # # #### # ##     ## # ### #####
# ##       ##  ## # # #         # # #  # ##      #
################################################ #
